推,噓,分數,作者,標題,時間
12,5,7,APPLEin5566 (泰山下智久),[問卦] 我睡了老闆的女兒，怎麼辦？,Fri Nov  8 23:48:13 2019
15,40,-25,mOoOm ( Simon),[新聞] 驚人預測 命理師看韓蔡得票數 居然發現,Sat Nov  9 07:10:12 2019
2,10,-8,mjj90138 (蔡包),[問卦] 洞六洞洞 部隊返陽,Sat Nov  9 06:21:52 2019
2,1,1,hmt17 (Popo:(bﾟ▽ﾟ)b),[問卦] 驚! 3年a班 川榮李奈 喜獲一子!,Sat Nov  9 03:39:13 2019
6,1,5,s511162004 (abcd1234),[問卦] 台中現在有什麼地方好去的,Sat Nov  9 10:25:09 2019
4,1,3,aa7713333 (PaulFrank),[問卦] 有沒有東興耀揚唱愛我別走的卦,Sat Nov  9 01:17:59 2019
9,5,4,black1x2y3z (安),[問卦] 飛機上要點什麼才顯得的專業？,Sat Nov  9 08:36:26 2019
161,154,7,Bignana (血神霸臨戰天下),[公告] 文殊起劍，十一月份置底閒聊區,Sat Nov  2 00:18:51 2019
2,1,1,Cassander (Cassander),[新聞] 邱純枝：有能力滿足菲國工業4.0與商用空調,Sat Nov  9 08:22:31 2019
36,2,34,z770808 (),[新聞] 關稅不炸了？川普驚人回應 引爆陸官媒怒,Sat Nov  9 11:30:11 2019
11,0,11,cutiehoneyzu (McHilo),[新聞] 12強複賽賽程出爐！台灣下周一起依序交手墨韓,Fri Nov  8 23:39:09 2019
3,0,3,isagoo (古先生),Re,Fri Nov  8 23:00:31 2019
10,15,-5,WaWa3 (寂寞的麻糬),[問卦] 好想跟肉肉女做愛怎辦？,Sat Nov  9 00:33:01 2019
6,15,-9,Lampaininder ( ),[新聞] 列民進黨不分區立委?王浩宇給神秘數字:3,Sat Nov  9 08:19:11 2019
8,1,7,lianpig5566 (家庭教師殺手里包恩),[問卦] 為什麼不用網路出國就好了,Sat Nov  9 01:44:52 2019
39,61,-22,davidex (玉藻前我的),[新聞] 嘆高雄選戰因「一碗魯肉飯」失利 陳菊：,Sat Nov  9 08:29:20 2019
6,1,5,TyuzuChou (子瑜我老婆),Re,Fri Nov  8 23:56:21 2019
258,3,255,petingo (皮挺哥),Re,Sat Nov  9 01:37:53 2019
6,0,6,qope (交女朋友好難),[問卦] 張國煒說愛飛機有可能是自我催眠嗎?,Fri Nov  8 23:50:31 2019
1,1,0,hth9494 (掰掰惹 仙度瑞拉),[問卦] 太魯閣號電線斷掉怎麼辦,Sat Nov  9 00:01:26 2019
6,1,5,satanhotdog (satanhotdog),Re,Sat Nov  9 11:12:59 2019
11,3,8,trylin (好人好事代表),[問卦] 獨立號墜毀了qqqqq,Sat Nov  9 01:16:05 2019
2,3,-1,brella (府城嚴選臭懶趴),Re,Fri Nov  8 23:45:18 2019
11,4,7,kevin91 (只發費文),[問卦] 跑完半馬發一堆勵志文的在想什麼？,Fri Nov  8 23:13:32 2019
3,0,3,fack3170 (法克),[問卦] PTT胡亂檢舉的情況是不是很嚴重?,Fri Nov  8 23:38:02 2019
3,0,3,gyGirl (妹),[問卦] 有沒有紅磚的八卦?,Sat Nov  9 11:52:25 2019
2,0,2,unclefucka (Comic Lo ),Re,Sat Nov  9 03:59:04 2019
7,4,3,OAO5566 (OAO),[問卦] 少子化是豪洨的嗎？,Fri Nov  8 22:58:59 2019
2,0,2,longyin (龍吟很難嗎？為什麼),Re,Sat Nov  9 10:54:40 2019
12,2,10,rescueme (小平),Re,Sat Nov  9 00:44:03 2019
11,75,-64,waymayday (不要問),[新聞] 韓唱《我現在要出征》 他驚藏有對高雄的,Sat Nov  9 10:40:14 2019
9,1,8,gentleman888 (),[新聞] 玻利維亞大選暴亂 女鎮長遭示威者私刑,Sat Nov  9 11:37:57 2019
6,0,6,gino0717 (gino0717),[問卦] 在福克蘭群島當總督是什麼感覺,Fri Nov  8 23:59:26 2019
4,6,-2,Rrrxddd (柯韓粉RR),Re,Sat Nov  9 11:48:03 2019
16,2,14,sodistrues (true),[問卦] 台灣人覺得九份老街不好玩 很普遍嗎？,Fri Nov  8 23:28:49 2019
32,4,28,jeff0025 (),[問卦] 朱元璋算是庶民皇帝嗎?,Sat Nov  9 09:16:20 2019
5,3,2,q5212 (q5212),[新聞] 傳捷報！朝陽科大資管系AI自動挑選水果AP,Sat Nov  9 11:51:22 2019
5,1,4,RodrigueZ810 (裝小維),[問卦] 有沒有帳號部隱版的八卦?,Sat Nov  9 11:26:28 2019
3,0,3,dlevel (府城中西里菜),Re,Sat Nov  9 11:36:40 2019
53,4,49,kid33 (),[新聞] 尷尬了！警攔停百萬名車 車窗敲不破？民,Sat Nov  9 10:14:14 2019
10,3,7,syearth (sysearth),Re,Sat Nov  9 10:50:01 2019
2,0,2,aabbcc520 (U質文),[問卦] 要如何把比較的心態拿掉的八卦,Fri Nov  8 23:39:41 2019
1,0,1,mynewid (before sunshit),Re,Sat Nov  9 09:04:21 2019
5,2,3,wer50888 (逢甲陳柏霖),[問卦] 買早餐遇到兩個歐巴桑排在一起要多久,Sat Nov  9 09:51:52 2019
3,15,-12,silver5566 (吟五六),[問卦] 進擊的巨人想要殺光牆外所有人?,Sat Nov  9 10:55:10 2019
3,0,3,k321045 (蒜泥厲害),[新聞] 關西機場跑道又封鎖，疑似發現無人機,Sat Nov  9 08:09:31 2019
7,3,4,chamge7788 (經濟王7887),[問卦] 綠碳化矽砂輪為何結合度都偏軟,Sat Nov  9 08:03:47 2019
3,0,3,chi12345678 (♥經典 FY細角),[問卦] 畫面的右邊有什麼？我很好奇！,Sat Nov  9 03:34:05 2019
5,1,4,iam168888888 (射精),[新聞] 林書豪決勝節扮關鍵要角 CBA北京首鋼3連,Fri Nov  8 23:39:19 2019
9,1,8,sheng612 (無聊的人),Re,Sat Nov  9 08:06:31 2019
3,0,3,q214789635 (9527),[問卦] 長大後會感覺電影預告臺配口白很中二嗎?,Sat Nov  9 00:59:10 2019
8,3,5,ccyaztfe (best_troll_tw),[問卦] 在早餐店被小蘿莉姐妹圍觀，該怎麼辦？,Sat Nov  9 09:27:27 2019
3,0,3,wuke (有人責備我們不夠深入),Re,Fri Nov  8 23:35:13 2019
0,0,0,songgood (ilovegoodgame),Re,Fri Nov  8 23:51:22 2019
7,6,1,AngryYouth (森寶),[問卦] 我兒子因為傷害罪進監獄,Sat Nov  9 00:54:40 2019
9,1,8,fireheart988 (耶嘿),[爆卦] 柏林圍牆倒塌30周年,Sat Nov  9 01:32:36 2019
25,5,20,yji3vu4gj4 (YJI),[問卦] 被還算好的同事私底下不認同怎麼辦？,Sat Nov  9 10:36:04 2019
4,1,3,misaka0120 (野格炸彈),[問卦] 台北哪邊有好ㄘ的川味酸辣湯,Sat Nov  9 02:33:23 2019
1,0,1,liang691206 (liang691206),Re,Sat Nov  9 08:21:42 2019
9,0,9,FuyumiIrisu (入須冬実),"[新聞] 華新集團捐5,000萬 助台北榮總購置先進醫",Sat Nov  9 07:55:49 2019
8,1,7,bbc0217 (hmmmmmmmmmmmmmmm... ...),[問卦] 人類活那麼久 怎麼都沒有像樣的殺蟑工具?,Sat Nov  9 00:45:09 2019
4,13,-9,eric19990726 (黃家祖師爺),[問卦] 沒睡的給我死進來,Sat Nov  9 04:47:08 2019
14,7,7,RoroyaZoro (最賤．問天譴),Re,Sat Nov  9 11:26:26 2019
3,3,0,y3226999 (咪苦說她喜歡我 >///<),[問卦] 轉蛋 (初音陣線文),Sat Nov  9 01:47:53 2019
6,0,6,deepdish (Keep The Faith),[問卦] 有沒有第四次工業革命的八卦？,Fri Nov  8 23:10:24 2019
6,7,-1,syearth (sysearth),[問卦] 為何有些離婚的台女 常常會讓人瞠目結舌?,Sat Nov  9 09:38:44 2019
5,0,5,jp6vu04boy (多多),[問卦] 什麼顏色的人比較好吃,Sat Nov  9 11:08:51 2019
4,2,2,gotopark (無限風光在險峰),[問卦] 12強對韓國，輸還是贏?,Sat Nov  9 09:53:23 2019
7,1,6,qqmaybenot (qq),[問卦] 微軟的EXCEL篩選功能獨步全球?,Sat Nov  9 08:44:37 2019
11,3,8,stu962046 (晴),[問卦] 為什麼眼科跟牙醫診所都裝潢舒適,Sat Nov  9 00:18:50 2019
10,4,6,fur (英國研究真有趣),Re,Sat Nov  9 00:08:57 2019
5,32,-27,TheZealot (TheZealot),[新聞] 千億基金助勞保!韓拋勞動3箭 無薪假給6成,Sat Nov  9 07:59:03 2019
10,0,10,andyzxcvbn (我想想),[問卦] 有線電視被youtube取代,Sat Nov  9 00:07:23 2019
4,1,3,Changyaya (),[問卦] 大樓管理員都是何方神聖,Fri Nov  8 23:36:12 2019
10,3,7,scores (男兒當逆天！),Re,Sat Nov  9 09:07:47 2019
33,1,32,Bignana (秋水浮萍任飄渺),[公告] 請勿於本板發表買賣帳號之相關言論,Thu Oct 24 13:14:38 2019
31,11,20,ketter (挖西林老背),[問卦] 為什麼飛機不起飛在原地就好,Sat Nov  9 00:37:11 2019
3,8,-5,suntory96 (suntory96),Re,Sat Nov  9 10:19:15 2019
3,0,3,SP500 (標準普爾),[新聞] 櫻島火山近3年最大噴發 噴煙竄升5500公尺,Sat Nov  9 10:49:57 2019
5,0,5,genius721105 (genius721105),[問卦] 這樣的條件可以買車嗎？,Sat Nov  9 00:43:43 2019
3,1,2,Fushimi (伏西米),[問卦] 夢裡點餐，沒吃到就醒來的卦,Sat Nov  9 03:36:35 2019
14,3,11,ilovemami (噁爛肥宅好搗亂癱瘓交通 ),[問卦] YT music能屌打apple跟Spotify 嗎,Sat Nov  9 00:12:20 2019
16,3,13,Ifault (Not my fault),[問卦] 外送平台的平台該怎麼解釋？,Sat Nov  9 03:04:51 2019
1,0,1,mother (老木),Re,Sat Nov  9 11:48:50 2019
1,1,0,cosmite (Z),[問卦] 美女你們想要看我的肉棒硬嗎,Fri Nov  8 23:05:56 2019
6,0,6,hizo (白木緋奏),[問卦] 西野七瀬與佐藤健拍廣告?~,Sat Nov  9 00:05:12 2019
7,1,6,krit1009 (肥龍公主),[問卦] 和運怎麼都知道？,Sat Nov  9 00:17:40 2019
2,0,2,koheik2 (ko),[問卦] 賁門看西醫有用嗎?,Sat Nov  9 11:02:49 2019
8,1,7,silent328kn (沈默羊),[問卦] 要怎麼擺脫賤民身分?,Sat Nov  9 01:07:41 2019
0,1,-1,PRME (我被水桶拉),Re,Sat Nov  9 02:28:25 2019
4,1,3,yuechen (亂轟阿翔),[新聞] 《絕地求生》2019世界冠軍賽明日起點燃戰火 首次釋出賽事主,Fri Nov  8 23:58:33 2019
3,13,-10,chao0210 (一步一腳印),[問卦]  hey　我真的好想你,Sat Nov  9 00:17:54 2019
4,4,0,bernie90006 (害羞ㄉ波妮 0///0),[問卦] 全世界組一支棒球隊和大聯盟PK有沒有勝算,Sat Nov  9 09:55:52 2019
27,4,23,syearth (sysearth),Re,Sat Nov  9 10:08:45 2019
4,0,4,mojojojo5217 (Mojo),[問卦] 第一個尻槍的人在想什麼？,Sat Nov  9 00:12:37 2019
0,0,0,lpbrother (LP哥(LP = Love & Peace)),Re,Sat Nov  9 10:19:12 2019
4,0,4,a221877890 (andy),[問卦]  當年兒童節收到禮物有多期待？,Sat Nov  9 02:00:21 2019
6,2,4,inmee (J),[問卦] 會在手機上面裝防毒軟體的都什麼人?,Sat Nov  9 09:30:02 2019
4,1,3,HDSM (Love Not Change  O'_'O),[問卦] 喝什麼最退火阿???,Fri Nov  8 23:59:14 2019
54,5,49,hmt17 (Popo:(bﾟ▽ﾟ)b),[新聞] 炎亞綸要演日劇了！女主角竟是「晨間劇女,Fri Nov  8 23:20:59 2019
5,0,5,keif (該如何面對~~),[問卦] 現在體罰不會有問題嗎？,Sat Nov  9 09:58:18 2019
58,4,54,rainnawind (第八罪正太之罪：雨颯),Re,Fri Nov  8 23:06:41 2019
43,4,39,tony77998 (偷尼柒柒玖玖捌),[新聞] 9男擠1間汽旅房3天 苗警台中查毒見槍上膛,Sat Nov  9 00:04:35 2019
5,2,3,alberchi (RELAX),[問卦] 屁股毛要用many還是much?,Sat Nov  9 01:13:17 2019
5,3,2,yokann (戰爆廢物黨工),[問卦] 有沒有台灣消費者心態的八卦,Sat Nov  9 07:29:02 2019
24,0,24,xianyao (艾瑪),Re,Sat Nov  9 07:45:38 2019
0,4,-4,xampp (xampp),[問卦] 單身公害,Sat Nov  9 04:33:22 2019
4,5,-1,DevilHotel (惡魔旅館),[問卦] 放假穿制服的妹子在想什麼,Sat Nov  9 11:09:50 2019
2,0,2,sq61372py (sq613),[問卦] 有沒有蘆花雞的八卦？,Sat Nov  9 02:08:19 2019
10,7,3,xianfen (Lily),[新聞] 韓冰打工買車送韓國瑜 林俊憲：南港豪宅,Sat Nov  9 11:39:33 2019
5,2,3,bbob (小海),[問卦] 有沒有人親眼看過國家機器的樣子?,Sat Nov  9 00:08:40 2019
5,0,5,liang691206 (liang691206),Re,Sat Nov  9 09:13:26 2019
47,2,45,LoveMakeLove (愛がすべて),[新聞]布袋戲電影《西幽玹歌》台日叫好 西川貴教,Sat Nov  9 08:01:59 2019
50,7,43,Y225 (阿凱),[新聞] 「郭宋配」有譜？　郭台銘：你們消息怎,Sat Nov  9 10:53:11 2019
4,5,-1,songgood (ilovegoodgame),[問卦] 幹水果亂切就好你以為在賣生魚片唷,Sat Nov  9 08:54:56 2019
11,1,10,EbinaHina (EbinaHina),[新聞] 燙傷用冰塊降溫反加劇傷害 醫師：沖水才,Sat Nov  9 08:27:29 2019
1,5,-4,bellas (小p),Re,Sat Nov  9 01:46:37 2019
9,1,8,liang691206 (liang691206),Re,Sat Nov  9 08:59:09 2019
3,3,0,pchunters123 (pp),[問卦] 前面有背後背包的擋路，可以直接撞開嗎,Sat Nov  9 10:00:43 2019
3,2,1,MiLuDaiBoom (ⓂⓛⓁⓤⒹⓐⓛⒷⓞⓞⓂ),[問卦] 凌晨兩點中,Sat Nov  9 02:25:17 2019
1,1,0,hclstarkid (=你看不到我=),[問卦] 有沒有香港01這新聞App 屌打國內ap,Sat Nov  9 11:36:51 2019
9,13,-4,Ras5566 (橡皮擦),[新聞] 為豪宅案酸小英？韓國瑜：長得一副聰明,Fri Nov  8 23:07:22 2019
4,2,2,firebm (..F.I.R.E.. BM),Re,Sat Nov  9 11:08:41 2019
13,1,12,b34mac2 (店長推薦作品),[問卦] 古巴三明治怎麼做的?,Sat Nov  9 02:33:17 2019
0,2,-2,twin1949tw (台北Station),Re,Sat Nov  9 08:23:30 2019
14,2,12,qazStarStar (我不是派大星),[問卦] 典獄長真的可以隨便殺人嗎?,Sat Nov  9 04:52:20 2019
8,0,8,DaGoDa (大哥大),Re,Sat Nov  9 07:55:45 2019
4,0,4,OAO5566 (OAO),[問卦] 為什麼不把它塗點果醬就把它吃掉啊？,Fri Nov  8 23:35:12 2019
12,4,8,olmtw (支持htc，支持台灣貨),[新聞] 太魯閣號集電弓斷扯電車線 今東部幹線將,Sat Nov  9 08:10:48 2019
191,14,177,Gotham (萬惡之城),[新聞] 林亮君退黨事前沒告知 林穎孟：錯愕、看,Fri Nov  8 23:30:30 2019
87,5,82,opengaydoor (開甲門),[問卦] 低收入戶出身的小孩 要考上台大有多難？,Sat Nov  9 09:14:38 2019
5,0,5,Superxixai (洪粉吱已),[問卦] 台灣好區壞區有像國外那樣誇張嗎？,Sat Nov  9 09:33:38 2019
3,1,2,TheDraggers (TheDraggers),[問卦] 幹幹幹幹幹，A片不小心開太大聲,Sat Nov  9 00:02:11 2019
19,3,16,yankae (kerker),[問卦] 喜歡看書跟歷史愛喝紅茶以後能幹麻,Sat Nov  9 02:25:13 2019
7,0,7,cloudyheart (雲心),Re,Sat Nov  9 05:06:40 2019
7,1,6,geordie (Geordie),Re,Sat Nov  9 09:01:21 2019
5,2,3,adf926 (呵呵蓋),[問卦] 欸誒欸插座頭是不是很像臉阿?,Sat Nov  9 07:44:12 2019
6,2,4,Oilboy (油膩Boy),[問卦] 好久好久的故事 是媽媽告訴我,Sat Nov  9 03:49:38 2019
6,2,4,Timekeeper (1450退散),[問卦] 如果大海能夠喚回曾經的愛,Sat Nov  9 01:35:57 2019
2,8,-6,drinkmuffin (暢飲鬆餅),[問卦] 伊莉雅絲菲爾當年有多紅？,Sat Nov  9 02:58:07 2019
34,4,30,Zeldaman (dadada),[問卦] MobileComm是不是最短視近利的地方？,Sat Nov  9 06:08:42 2019
3,3,0,fur (英國研究真有趣),[問卦] 為什麼你各位不肯信耶穌還要毀謗祂？,Sat Nov  9 00:54:01 2019
5,2,3,three88720 (不要跟我起爭yee啦!),[問卦] 玻璃清潔劑對蚊子超有效,Sat Nov  9 00:12:34 2019
4,3,1,hk5566 (),[問卦] 穿過鞋子踩下去會發光的都幾歲了？,Fri Nov  8 23:53:24 2019
1,1,0,yuahang (橘花貓),Re,Sat Nov  9 09:46:48 2019
0,2,-2,wangyc (粒咲杏子的老公),[問卦] 肥宅去韓國吃魚有加分嗎？,Sat Nov  9 00:04:29 2019
8,1,7,ianlin1216 (伊恩可可),[問卦] 鴿子不會飛走代表什麼,Sat Nov  9 07:48:21 2019
9,0,9,spartaucs896 (夢醒十分),[問卦] 把鬼片中的門都拆掉會怎樣？,Fri Nov  8 23:42:42 2019
0,0,0,tobetwob (),[新聞] 遏止電子煙 川普擬將購買年齡提高至21歲,Sat Nov  9 03:20:34 2019
1,8,-7,zz2895341 (煙大屌宅男),Re,Sat Nov  9 10:28:42 2019
8,2,6,weido (維逗),[問卦] 東南亞的機車輪胎很大一顆,Sat Nov  9 09:44:40 2019
9,2,7,meokay (我可以),[問卦] 認真問，要2020了路上還有人在賣愛心筆,Sat Nov  9 10:18:35 2019
11,3,8,goldenhill (我的人權時代),[新聞] 中國水果「賣不掉、吃不起」 誰是禍首？,Sat Nov  9 10:54:35 2019
0,7,-7,hsiao15165 (notdragon),[問卦] 刺青妹子在想什麼？,Sat Nov  9 00:01:18 2019
12,2,10,powyo (光子郎),[問卦] 新中華一番 這什麼到底什麼糞作?,Sat Nov  9 09:27:43 2019
16,14,2,takase (............),"[新聞] 提問時力不分區遭轟,成林亮君退黨關鍵",Sat Nov  9 10:04:33 2019
13,8,5,energy4924 (魯肥宅),[問卦] 有沒有吳宗憲很親民的掛,Sat Nov  9 01:21:09 2019
6,0,6,chart (まどか　ＮＯ.１ ＼(^O^)),[新聞] 違規超車橫停拒檢 駕駛躲車內警方破窗抓人,Fri Nov  8 23:33:04 2019
12,0,12,e584886401 (嵩嘎滅隙),[問卦] 肥貓好肥,Sat Nov  9 10:16:07 2019
2,2,0,cosmite (Z),Re,Sat Nov  9 01:52:21 2019
11,49,-38,flyer1998 (闊),[新聞] 韓國瑜批蔡政府：跟匈奴一樣不停掠奪,Sat Nov  9 11:25:56 2019
2,2,0,z5419 (邱哥),[問卦] 認真問個問題,Sat Nov  9 03:03:59 2019
3,0,3,system303179 (Simon11034),Re,Sat Nov  9 09:12:17 2019
10,5,5,KennethC (Smith),[問卦] 為什麼電腦主機要做這麼大?,Sat Nov  9 01:29:38 2019
31,10,21,chidiao (Archibald),[新聞] 大巨蛋遠雄電腦模擬被抓疑點 都發局長跳,Fri Nov  8 23:39:45 2019
7,2,5,sbflight (蜂西園主人),Re,Sat Nov  9 10:04:46 2019
10,0,10,WomanizerNo7 (花無缺),[問卦] 買台Po的都是那種人？,Sat Nov  9 11:26:27 2019
13,11,2,seand8088503 (あいうえお),[問卦] 為什麼呆丸人那麼會用塑膠袋啊？,Sat Nov  9 09:34:05 2019
0,1,-1,eateat14 (SHERLOCKZH),[問卦] 有沒有祕密搜查官的八卦?,Fri Nov  8 23:25:10 2019
0,0,0,inmee (J),[問卦] 朋友被人追殺該怎麼幫他?,Fri Nov  8 23:51:12 2019
5,3,2,Beanoodle (津崎似超人平匡先生),[問卦] 聖結石告人嗎？,Fri Nov  8 23:47:02 2019
20,7,13,eierom (非),[問卦] 台灣是不是被大陸商品入侵的很嚴重,Sat Nov  9 08:01:15 2019
12,1,11,gentleman888 (),[問卦] 用鼓棒打肥宅肚子會發出什麼聲音？☺☺☺,Sat Nov  9 11:07:14 2019
3,0,3,sHakZit75 (我還是做得到ㄉ),[問卦] 現在哪間大魯閣還有職棒投手影像?,Sat Nov  9 00:53:39 2019
34,7,27,rubric (),[問卦] 雙螢幕和大螢幕哪個方便的八卦,Sat Nov  9 11:39:42 2019
46,5,41,d841129 (腦殘),[問卦] 在景美女中當16歲正妹高中生是什麼港覺?,Sat Nov  9 00:08:17 2019
21,5,16,sodistrues (true),[問卦]宮崎駿說神隱少女無關九份  日本人不信？,Sat Nov  9 09:53:35 2019
2,0,2,GentleJena (耶拿),[問卦] 如果高坂麗奈當初加入的是輕音部,Fri Nov  8 23:05:11 2019
411,104,307,Wojnarowski (@wojespn),[新聞] 馬英九酸「自我感覺良好」　蔡英文笑回：,Sat Nov  9 10:27:52 2019
5,2,3,vic9503 (babyface),[問卦] 滑手機可不可以不要再皺眉頭了！,Sat Nov  9 00:43:54 2019
2,3,-1,chao0210 (一步一腳印),[新聞] 聯強開賣DJI RoboMaster S1編程機器人 ,Fri Nov  8 23:43:27 2019
7,6,1,zoosleep (王者),[問卦] 愛莉莎莎戴魚夫帽?,Fri Nov  8 23:30:44 2019
182,42,140,shinmoner (WISDOM),[新聞] 8年5萬戶公宅跳票？柯文哲認了「蓋不完」,Fri Nov  8 23:45:25 2019
2,0,2,Cger (海洋~~),Re,Sat Nov  9 02:02:37 2019
8,1,7,CavendishJr (左是炎右是雷),[問卦] 小丑魚竟然可以性轉!?,Sat Nov  9 10:06:16 2019
4,2,2,ji3ji3ji3 (~夏夜晚風~),[問卦] 有口臭的人 自己聞不出來嗎,Sat Nov  9 11:50:02 2019
19,0,19,xw741953 (孤獨魂),Re,Fri Nov  8 23:35:27 2019
12,2,10,qazsedcft (自由羊),[新聞] 午夜開搶！網購新勁戰現省5萬　11元買到,Sat Nov  9 00:02:57 2019
11,3,8,piggy37 (小時),[問卦] 請問退休可以領600萬真的嗎？,Sat Nov  9 08:23:03 2019
7,7,0,Hscyin (114負荷粉),[問卦] 有沒有蚊子會抬後腿的八卦？,Sat Nov  9 02:41:24 2019
4,8,-4,Shiau5566 (優文Shiau),[問卦] 橘貓站在馬路旁很徬徨？,Sat Nov  9 00:46:11 2019
2,0,2,ccyaztfe (best_troll_tw),[問卦] edm跟epic music聽起來很類似？,Fri Nov  8 23:35:22 2019
49,6,43,Bignana (秋水浮萍任飄渺),[公告] ptt帳號 20萬元 你會賣嗎？ 討論串,Thu Oct 24 13:20:10 2019
8,2,6,mean (機器人跌倒了),Re,Sat Nov  9 11:34:27 2019
9,2,7,b8301013 (葉子),[問卦] 布偶貓跟米克斯的差別在哪？,Sat Nov  9 10:44:57 2019
90,7,83,torrest (torrest),[問卦] 禁新辦帳號的後遺症？,Sat Nov  9 09:24:55 2019
11,3,8,VVVV5555 (東興烏鴉-耀揚哥),[問卦] 香港算是慢性自殺嗎,Sat Nov  9 10:24:31 2019
1,0,1,ezJapan (Japan),[問卦] 腸病毒幾時開始流行的,Fri Nov  8 23:28:41 2019
2,1,1,st9760916 (st9760916),[問卦] 在新加坡附近的沉船發現藍寶石？,Sat Nov  9 00:35:49 2019
1,0,1,kjupsp (來自西發里亞的明日),[問卦] 這世界將要屬於愛 不屬於強者的世代,Sat Nov  9 01:12:25 2019
2,6,-4,s37166117 (ace),[問卦] 資工系該去做什麼職業蛤,Fri Nov  8 23:52:50 2019
2,0,2,vickyshan (逗比小精靈),[問卦] 敢對司徒浩南耍大牌的中國演員是誰阿,Sat Nov  9 03:07:06 2019
6,2,4,ZengMaktub (改個暱稱),[問卦] 一般人請假可以請多久？,Sat Nov  9 10:00:54 2019
0,0,0,burgergirl (20 seconds insane),[問卦] 新莊區有人虐狗如何處理,Sat Nov  9 02:50:19 2019
5,2,3,ilovemami (噁爛肥宅好搗亂癱瘓交通 ),[問卦] 監所管理員會怕囚犯嗎,Sat Nov  9 04:26:21 2019
4,3,1,ryanworld (涼粉),Re,Sat Nov  9 10:33:10 2019
4,1,3,bonfferoni (白莖汁腥),[問卦] 快五十歲的女同事叫人家清潔阿姨?,Fri Nov  8 23:06:37 2019
0,4,-4,russkgb (旅途),政府公開資訊，差異化？,Sat Nov  9 10:39:42 2019
105,43,62,deepdish (Keep The Faith),[新聞] 爆乳牙助辭工作開直播 只花2年收入翻N倍,Sat Nov  9 08:04:10 2019
4,0,4,linx210145 (hotnet),Re,Sat Nov  9 10:53:56 2019
13,7,6,gg0815 (O0O0O0O0O0O0O0),[問卦] 大小S當年有多紅,Sat Nov  9 07:25:27 2019
148,23,125,tw689 (台灣689),[新聞] 林亮君退黨 北市議會時力黨團瓦解,Sat Nov  9 02:00:30 2019
7,0,7,takeshi911 (L.Lawlite),[新聞] 國中生不愛用肥皂洗手 小心諾羅病毒易群,Sat Nov  9 10:37:35 2019
1,1,0,ht91008 (色情狂),[問卦] 幹嘛要買武器，年輕人投票就能保家衛國？,Fri Nov  8 23:47:21 2019
0,0,0,todao (心裡有數),[問卦] 為弱勢階層服務的建築師,Sat Nov  9 10:31:02 2019
12,5,7,poeta (鍵盤詩人),[新聞] 疑把煞車當油門 老翁開車暴衝撞騎樓3人,Sat Nov  9 00:57:00 2019
8,2,6,ccxx9999 (0-0),[新聞] 女性內衣問卷調查 噁心男騙拍裸照還上下,Sat Nov  9 08:54:08 2019
3,0,3,ckbdfrst (ckbdfrst),Re,Sat Nov  9 02:19:46 2019
2,0,2,fraternity (duhamanity可以原諒他阿1),[問卦] 中國怎麼感覺很嫉妒金馬獎??,Sat Nov  9 00:11:38 2019
43,0,43,hanmas (),Re,Sat Nov  9 02:36:55 2019
4,26,-22,zoosleep (王者),[新聞] 影／小玉挑戰對折紙12次世界紀錄　轎車,Sat Nov  9 00:21:51 2019
11,20,-9,nuggets (舟彿全槐),[新聞] 批綠只有三招 韓國瑜：屁股幾根毛看得一,Fri Nov  8 23:07:10 2019
3,0,3,H2 (超級噴火龍X),Re,Sat Nov  9 10:33:20 2019
7,1,6,shampoopoo (毛寶洗髮精是了),[問卦] 帥哥教授只跟我打招呼的卦？,Sat Nov  9 08:17:41 2019
22,1,21,nesiron (Nes),[問卦] 吉田羊，深川麻衣，稻森泉，都幾？,Sat Nov  9 00:06:28 2019
2,10,-8,abellea85209 (阿比利亞),[新聞] 大網紅？奈米網紅？原來館長跟蔡阿嘎竟是,Fri Nov  8 23:12:07 2019
4,1,3,nonpolar (Nonpolar),Re,Sat Nov  9 10:26:20 2019
7,4,3,plusonezero (本草綱目科屬種),[問卦] 宏達電當年有多紅？,Sat Nov  9 01:40:59 2019
8,3,5,ckbdfrst (ckbdfrst),[新聞]柏林圍牆倒塌30年 德東青年世代依舊壁壘分,Fri Nov  8 23:38:42 2019
3,2,1,andy02 (大蛇丸),[問卦] 為什麼有人希望秋天別來?,Sat Nov  9 10:18:49 2019
61,7,54,a41141234 (跨三小啦幹),[問卦] 有誰跟我一樣不信鬼神?,Sat Nov  9 03:49:28 2019
1,0,1,livemail (即時現場),[問卦] 約ㄋ出來的第一個藉口,Fri Nov  8 23:27:43 2019
1,0,1,ptt987654321 (哪部自己私訊問我),Re,Sat Nov  9 11:37:06 2019
12,5,7,iPenis (蘋果新產品 iPenis),[新聞] 高嘉瑜談阿扁失言？ 他轟：將惹來無法承,Fri Nov  8 23:26:01 2019
9,4,5,linhunk (hihihi),"[問卦] ""都幾"" 是時麼意思",Sat Nov  9 02:13:55 2019
22,1,21,postar (郵星),[新聞] 傳改推郭宋配拚總統大選 親民黨：請外界,Sat Nov  9 10:03:10 2019
3,0,3,Beanoodle (津崎似超人平匡先生),Re,Fri Nov  8 23:18:27 2019
21,82,-61,ccf52881 (ccf52881),[新聞] 「放韓假」24天 上節目喊「想念高雄市民,Sat Nov  9 10:15:21 2019
2,2,0,chadmu (查德姆),[問卦] 熊浮力消失了？,Fri Nov  8 23:57:33 2019
74,6,68,sodistrues (true),[問卦]日本高中生來台灣畢業旅行 強迫穿制服？,Sat Nov  9 11:01:38 2019
13,1,12,KENDO777 (KENDO777),[問卦] 為什麼會有人反對整型?,Sat Nov  9 03:21:52 2019
5,0,5,kugga (ン・ダグバ・ゼバ),Re,Sat Nov  9 01:06:22 2019
8,3,5,valsechopin (往前走 不回頭),[問卦] 有沒有尼非彼多的八卦,Sat Nov  9 02:18:12 2019
14,8,6,orze04 (orz),[新聞] 外長吳釗燮：如經濟差威脅中共合法性 兩,Sat Nov  9 06:47:03 2019
19,2,17,Ayanami5566 (綾波五六),[問卦] 米卡莎跟希斯特莉亞要怎麼選?,Fri Nov  8 22:54:04 2019
5,1,4,lpbrother (LP哥(LP = Love & Peace)),Re,Sat Nov  9 07:05:43 2019
4,2,2,nonnon (にゃんぱすー),[問卦] 如果平澤唯當初加入的是吹奏樂部,Fri Nov  8 23:01:04 2019
5,0,5,cowardlyman (有功夫無懦夫),[新聞] 美中同意逐步取消關稅？庫德洛證實談判進,Sat Nov  9 00:41:18 2019
4,0,4,ianlin1216 (伊恩可可),[問卦] 我這樣是不是很壞,Sat Nov  9 06:37:57 2019
0,7,-7,sean12345678 (風),Re,Fri Nov  8 23:41:38 2019
5,1,4,sazabik (SAZABI),[問卦] 台灣知名都市的堂號？,Sat Nov  9 09:14:18 2019
6,1,5,tsukasaxx (香瓜百分百),[問卦] 清末是不是暗殺事件頻頻發生？,Sat Nov  9 09:10:49 2019
8,3,5,AllenHuang (∴'☆:∵★.＼:),[新聞] 豪宅案韓國瑜隱私被侵害? 黃國昌酸:庶民,Sat Nov  9 11:46:09 2019
22,4,18,fawangching (陳先生),[問卦] 少子化未來誰去工地上班？,Sat Nov  9 09:18:36 2019
3,0,3,sugiuchi (bt),Re,Sat Nov  9 00:31:03 2019
2,1,1,tatty5566 ( ),[問卦] 友寄隆輝現在在幹嘛,Fri Nov  8 23:58:10 2019
9,2,7,krit1009 (肥龍公主),[問卦] 穿窄裙怎麼坐摩托車？,Fri Nov  8 22:54:37 2019
8,1,7,hk410050 (A柏),[新聞] 影／海能風電陸域工程動土 竹南後龍外海,Sat Nov  9 09:23:11 2019
17,1,16,jack125125 (刀無極),[新聞] 南投養生會館愈開愈多 民諷「養雞館」 ,Sat Nov  9 10:47:55 2019
3,3,0,lycs0908 (岳岳),[問卦] 早在活動開幕前去過有多爽,Sat Nov  9 11:30:52 2019
10,2,8,csi9507121 (Corydoras),[問卦] 凶宅被都更後還算凶宅嗎?,Sat Nov  9 00:26:33 2019
3,3,0,bbob (小海),[問卦] 兩個亞洲女孩吃一根黑棒是否有趣?,Sat Nov  9 08:39:49 2019
1,4,-3,chidiao (Archibald),Re,Fri Nov  8 23:24:02 2019
55,2,53,herex (敗者成塵),[問卦] 腳很臭怎麼治?,Sat Nov  9 05:14:17 2019
13,6,7,purine5566 (漂亮56),[問卦] 女生露出駱駝蹄算色情圖片嗎?,Sat Nov  9 01:48:33 2019
5,4,1,ivorysoap (ivorysoap),[新聞] 連2天跑雲林造勢 總統蔡英文說出原因了..,Sat Nov  9 09:50:33 2019
12,1,11,geordie (Geordie),[新聞] 法學者：馬克宏訪中任務成功 國民黨立場,Sat Nov  9 08:49:35 2019
1,3,-2,ceramicfa (ceramicfa),[問卦] 女按摩師按摩的時候要望著她嗎,Fri Nov  8 23:47:06 2019
13,89,-76,tiger911 (胖虎),[新聞] 韓國瑜批民進黨選舉只有敢 國民黨有禮義,Sat Nov  9 08:35:29 2019
13,27,-14,LIN9 (LIN9),[新聞] 跨黨大咖相繼為洪慈庸站台 賴清德今現身,Sat Nov  9 09:59:35 2019
10,3,7,XperiaZ6C (索尼),[問卦] 全台灣是不是只有我沒槍啊？,Sat Nov  9 00:25:45 2019
7,3,4,Eangel (),[問卦] 大家都沒錢，何不組團去抓貴婦奈奈？,Sat Nov  9 00:10:38 2019
8,1,7,sunkiss5566 (0.0),[問卦] 噴了五次的感覺是什麼境界0.0,Fri Nov  8 23:16:59 2019
5,3,2,Deadfisheyes (死魚眼),[問卦] 大佛鋼彈如何啟動？,Sat Nov  9 11:12:42 2019
2,2,0,tsisni (努力步上軌道),[問卦] 急!立可白沒水怎麼辦?,Fri Nov  8 23:03:36 2019
7,0,7,akila08539 (平手友梨奈我老婆),[問卦] 橋本奈々未對於吃的堅持,Fri Nov  8 23:59:21 2019
1,0,1,songgood (ilovegoodgame),Re,Fri Nov  8 23:57:29 2019
15,3,12,uhow (公館小蘿蔔頭),[爆卦] 太魯閣號256次電纜線掉落,Sat Nov  9 00:03:50 2019
4,0,4,jamselee (jamselee),Re,Sat Nov  9 02:10:53 2019
5,2,3,unclefucka (Comic Lo ),Re,Sat Nov  9 04:14:51 2019
7,3,4,qqmaybenot (qq),[問卦] 日本是不是起司控的天堂?,Sat Nov  9 10:06:47 2019
9,5,4,zz2895341 (煙大屌宅男),[問卦] 你們有吃過妹妹的大便嗎??,Sat Nov  9 10:00:12 2019
9,2,7,cycutom (cycutom),[問卦] 遊戲訂閱制給你，其實你也沒時間玩？= =,Sat Nov  9 06:25:20 2019
21,0,21,nk11208z (小魯),[新聞] 台大平台成績全被改87分 原是資工系學生,Sat Nov  9 06:55:53 2019
3,3,0,SsinAndy (土司硬安迪),Re,Fri Nov  8 23:10:49 2019
7,6,1,timetolove (艾爾不怕西諾),"[問卦] 欸欸 , G軟辦感謝祭的話有人會去嗎?",Sat Nov  9 04:01:31 2019
7,0,7,puppy97503 (趴皮),[爆卦] 車次256 太魯閣號 往花蓮 暫停中,Sat Nov  9 00:01:13 2019
0,7,-7,mean (機器人跌倒了),Re,Sat Nov  9 11:45:59 2019
15,5,10,zz2895341 (煙大屌宅男),[問卦] 說紅樓後面是高鶚寫的 是不是腦袋有洞??,Sat Nov  9 00:45:16 2019
94,5,89,mlkj (￾N                    ),[新聞] 經濟學人 蜂蜜陷阱 中國對台26條措施,Fri Nov  8 23:13:42 2019
10,1,9,fuxdk (肉身入地獄文的態度嗎),Re,Sat Nov  9 08:35:57 2019
7,0,7,TenbeensWu (薇子),[問卦] 重甲機神有沒有業界血汗內幕？,Sat Nov  9 00:31:38 2019
6,8,-2,qazStarStar (我不是派大星),[問卦] PTT的信箱是不是很小?,Sat Nov  9 05:19:54 2019
50,284,-234,moneybuy (),[新聞] 請假20多天…韓國瑜「想念高雄市民」：,Sat Nov  9 02:51:14 2019
8,0,8,shala (沙羅是轉換後的文字檔打m),[問卦] 這是什麼釐米小蟲？,Sat Nov  9 08:25:48 2019
11,21,-10,vc5566 (凡事有理即站得住腳),[新聞] 他一看韓國瑜臉上「龍鬚」 驚爆總統路危,Sat Nov  9 09:21:05 2019
0,2,-2,cosmite (Z),[問卦] 網友突然砍帳號,Fri Nov  8 23:37:03 2019
6,2,4,anti87 (天機老人),[新聞] 華為5G設備太好用瘋搶 盟友不聽勸老美火,Sat Nov  9 10:29:26 2019
9,0,9,fack3170 (法克),[問卦] 對倉野尾成美Fall In Love的感覺,Fri Nov  8 23:59:30 2019
8,1,7,jack125125 (刀無極),[問卦] 台灣人是不是比歐洲人富有?,Sat Nov  9 11:10:17 2019
15,5,10,Dean1128 (Dean),[問卦] 台鐵危機處理是不是爛到底,Sat Nov  9 10:45:01 2019
6,1,5,shiningwiz (黃斑貓迷姦系列),[問卦] 這是蟑螂嗎？急！在線等！,Sat Nov  9 03:58:42 2019
1,2,-1,chamge7788 (經濟王7887),[問卦] 八德永豐路中華路紅綠燈秒數誰設定的,Sat Nov  9 08:52:59 2019
1,4,-3,ltyintw (菈米雅嘶嘶),Re,Sat Nov  9 00:42:40 2019
31,4,27,bassmaster (貝斯斐肥),[問卦] 張震嶽當年有多紅,Sat Nov  9 00:59:47 2019
8,9,-1,area41gold (area41gold在炫耀？哥單s),[新聞]KIMIKO鉛筆美腿0贅肉超辣 網一看驚嚇：下,Sat Nov  9 04:52:37 2019
7,3,4,ChenDotQ (淘淘愛丟力),Re,Sat Nov  9 01:05:57 2019
26,1,25,blueskybird (曉昀),Re,Sat Nov  9 11:37:55 2019
10,0,10,IamCuteGirl (CuteGirl5566),[問卦] 霍格華茲是真的嗎？,Fri Nov  8 22:57:49 2019
18,4,14,jacklyl (全力殲滅糞兔兔卡娜赫拉),[問卦] 台灣到底好還是不好,Fri Nov  8 23:02:19 2019
9,11,-2,ivorysoap (ivorysoap),[問卦] 想看中途島卻被爆雷日軍戰敗損失四個老婆,Sat Nov  9 00:47:06 2019
47,2,45,zzing (zzzzzzing),[問卦] 陶喆當年有多紅,Sat Nov  9 03:24:11 2019
10,1,9,jacklyl (全力殲滅糞兔兔卡娜赫拉),[問卦] 一人說一個自己最討厭的動物,Fri Nov  8 23:39:36 2019
9,0,9,spin5566 (自旋五六),[問卦] 跟朋友出門都在滑手機 現在什麼情形?,Sat Nov  9 10:02:03 2019
7,0,7,qqq87112 (kaim),[新聞] 成吉思汗」台南插旗意願高！館長豪語：,Sat Nov  9 10:30:41 2019
15,2,13,lamigo520 (菜市口阿勇),[問卦] 魚的記憶力有多差？,Sat Nov  9 09:03:49 2019
0,4,-4,viable (隱士灰原I),[問卦] 要開始交往就預見結束的心情,Sat Nov  9 06:38:31 2019
15,1,14,rescueme (小平),Re,Sat Nov  9 07:29:03 2019
3,1,2,HayamaKami (台大彭于晏),[問卦] 請問台灣有空降消防員嗎,Sat Nov  9 07:18:16 2019
5,2,3,longyin (龍吟很難嗎？為什麼),Re,Sat Nov  9 11:28:05 2019
0,0,0,haijin (),[新聞] 出席金磚峰會 習近平將訪希臘、巴西,Sat Nov  9 08:17:12 2019
89,6,83,TName (真相就是指路燈 時間到了),[新聞] 川普：我尚未同意取消關稅 是中方想要,Sat Nov  9 10:01:17 2019
0,0,0,OusakaMegumu (逢坂恵夢),Re,Fri Nov  8 22:57:31 2019
0,3,-3,BD1983 (神氣活現),[問卦] 空氣清淨機,Sat Nov  9 09:45:19 2019
5,2,3,hmt17 (Popo:(bﾟ▽ﾟ)b),[問卦] 慟! 吉岡里帆變成喪屍的卦?,Fri Nov  8 23:37:23 2019
7,6,1,ep301177 (新竹山下智久),[問卦] 鮭魚煮湯還是煎的比較好？,Sat Nov  9 09:54:42 2019
7,2,5,s900144 (zaza),[問卦] 硬吃大王麻辣乾麵浪費健保無法可管嗎,Sat Nov  9 11:49:48 2019
6,3,3,kinggbic (kinggbic),[問卦] 台灣人被騙過一次容易再被騙嗎？,Sat Nov  9 10:31:31 2019
9,2,7,linhunk (hihihi),[問卦] 為什麼國高中小學 不用VR上學就好?,Sat Nov  9 03:21:17 2019
127,15,112,mikejason38 (阿@),[問卦] 有沒有出國7點還不起床的八卦,Sat Nov  9 08:56:04 2019
1,0,1,algebraic (algebraic),[問卦] 一天沒發滿兩篇會很虧嗎,Fri Nov  8 23:46:57 2019
12,1,11,xianyao (艾瑪),[新聞] 新橋站附近的公園裡發現埋藏女嬰屍體,Sat Nov  9 07:26:14 2019
68,5,63,SonyXperiaZ3 (覺青改五 領好多1450),[新聞] 過兩天才正式宣布！韓國瑜透露 副手找到,Fri Nov  8 23:50:32 2019
0,0,0,arsonlolita (蘿莉塔),[公告] 八卦板板規(2019.08.21),Wed Aug 21 08:33:39 2019
6,0,6,Nick87061319 (Nick),[問卦] 韓國是不是很愛subway ,Sat Nov  9 10:19:27 2019
19,7,12,ryohgi (青蛙錢包),[問卦] 怎麼繞過槍砲彈藥刀械管制條例？,Sat Nov  9 01:10:18 2019
52,0,52,qqqwsd (波波),[問卦] 第一個發明泡麵的是不是天才？,Sat Nov  9 02:25:51 2019
1,1,0,SaberMyWifi (賽巴),[問卦] 道奇毒蛇是來跟賓士搶什麼飲料妹啦,Sat Nov  9 00:35:56 2019
5,0,5,sasaki3630 (♥夏美子の老公 ♥),[問卦] 為何現在越來越多甲了?,Fri Nov  8 23:35:06 2019
13,3,10,wwf0322 (奴才),[新聞] 29歲廚師拿掃把瞄準同事屁屁！ 整根長柄,Sat Nov  9 08:16:48 2019
13,0,13,uwmtsa (補刀),Re,Sat Nov  9 04:06:50 2019
4,1,3,tomioki (Tomi),[問卦] 熊大上菜是不是一款很殘忍的遊戲？,Sat Nov  9 00:38:25 2019
8,0,8,emperor (愛派蘿ですがなにか？),[問卦] 日本妹子現在還流行瘋狂做愛心便當嗎?,Sat Nov  9 00:10:03 2019
18,11,7,xianyao (艾瑪),[公告] 水桶,Sat Nov  9 06:43:40 2019
38,1,37,samgreco (55),[新聞] 英國貨櫃車39死慘案　越南公安部證實：,Sat Nov  9 10:37:50 2019
18,9,9,sean12345678 (風),[問卦] 台北40萬，台中80萬，選哪個？,Fri Nov  8 23:55:17 2019
8,4,4,RLAPH (川尻浩作),[問卦] 小蘿莉想當YTer要拍什麼比較好？,Sat Nov  9 01:26:16 2019
4,4,0,CavendishJr (左是炎右是雷),[問卦] 果然還是雷姆好,Sat Nov  9 07:16:49 2019
4,0,4,bear2008 (阿兩:所長~~~~~),[問卦] 安齋らら是哪位日本女星 很紅嗎？,Sat Nov  9 08:23:28 2019
4,1,3,TigerMask (奇跡之虎),[問卦] 為什麼高進會用頭髮換牌那招啊？,Sat Nov  9 00:31:46 2019
7,1,6,Ironstick (鋼鐵蛇),[問卦] 明明要周休了 貓貓卻嗨不起來的八卦？,Sat Nov  9 01:01:12 2019
3,3,0,gracew0709 (小熊維尼·pooh雪芙寶貝),[問卦] 韓國瑜伽老師上課會亂教學生嗎,Sat Nov  9 01:04:02 2019
28,13,15,OdaTakeda (織田武田家),Re,Sat Nov  9 00:14:21 2019
7,28,-21,wang1b (唯i廢文<3),[問卦] 鷹流拉麵要吃哪家,Sat Nov  9 01:33:15 2019
11,0,11,MADUMA (水彩),[問卦] 說到富豪.建商.地主.財團會想到哪裡？,Sat Nov  9 08:53:04 2019
9,2,7,skywould (賽普勒斯),[問卦] 一篇好的廢文要包含哪些點?,Sat Nov  9 01:24:18 2019
2,3,-1,gg0815 (O0O0O0O0O0O0O0),[問卦] 掉頭髮的八卦,Sat Nov  9 03:21:50 2019
28,7,21,Asclepius (天...無言),"[新聞] 前九月稅收1兆8,693億元 創歷年新高",Sat Nov  9 10:02:26 2019
0,2,-2,Ayanami5566 (綾波五六),[問卦] 福利熊的薪水有多少?,Fri Nov  8 23:53:05 2019
16,4,12,AngryYouth (森寶),[新聞] 下面狂變大 男嗨炫褲穿不下 醫一看嘆切掉,Sat Nov  9 00:42:57 2019
7,2,5,XperiaZ6C (索尼),[問卦] 能躲子彈還不夠快嗎,Sat Nov  9 06:59:20 2019
3,2,1,Rasin (雷森),[問卦] 聘請員工性別的八卦,Sat Nov  9 00:03:58 2019
2,2,0,planA (planA),[問卦] 這是什麼蟲？,Sat Nov  9 10:42:29 2019
9,3,6,lpbrother (LP哥(LP = Love & Peace)),[問卦] 台大怎不要多蓋幾棟宿舍讓年輕人住？,Sat Nov  9 07:39:05 2019
7,0,7,s910 (s910),[問卦] 有沒有大家總是覺得宜蘭很小的八卦?,Fri Nov  8 23:13:07 2019
8,7,1,Tapqou (三三三),[新聞] 這些商圈客人不見了…學校停辦、北遷 衝,Sat Nov  9 09:22:08 2019
4,1,3,Rrrxddd (柯韓粉RR),[問卦] 大家推薦 什麼有噴宵夜,Sat Nov  9 03:32:46 2019
2,0,2,bul (腹內原來草莽),[問卦] 會不會這兩天開始全台豪宅大搜查的卦?!,Sat Nov  9 10:21:59 2019
1,4,-3,songgood (ilovegoodgame),Re,Sat Nov  9 09:07:35 2019
7,2,5,vodkalime607 (一直跑下去),[新聞] SOGO周年慶 台北三店首日飆11億,Sat Nov  9 08:36:33 2019
8,0,8,cj4385283 (Linhi),[問卦] 業務接到學校的單是不是很爽,Sat Nov  9 00:35:43 2019
13,2,11,newhander (新警察),Re,Sat Nov  9 11:04:36 2019
3,0,3,ki43oscar (一式戰－隼),[問卦] 地區的產業一條街,Fri Nov  8 23:28:25 2019
8,1,7,sHakZit75 (我還是做得到ㄉ),[問卦] 要去看紫羅蘭永恆花園,Sat Nov  9 03:17:21 2019
10,2,8,funasake (),[問卦] 夜市賣什麼最賺？,Sat Nov  9 11:13:26 2019
0,0,0,soul5566 (校排前五帥),Re,Sat Nov  9 01:32:01 2019
3,0,3,liang691206 (liang691206),Re,Sat Nov  9 08:49:41 2019
0,4,-4,MiLuDaiBoom (ⓂⓛⓁⓤⒹⓐⓛⒷⓞⓞⓂ),[問卦] 身旁的男男女女感覺渴求愛情,Sat Nov  9 02:48:51 2019
17,12,5,radiohead56 (L o S e r f a t n e r D),[新聞] 干預台灣大選 美智庫：中國積極散播挺韓,Sat Nov  9 00:11:56 2019
4,3,1,doraBBO (天才小釣手),[問卦] 會相信紐約租金中位數1300鎂是怎樣的人？,Sat Nov  9 10:39:45 2019
23,0,23,ramataiwan (rama),[新聞] 外送App店內價 竟比實體店面購餐貴,Sat Nov  9 06:38:38 2019
2,5,-3,tony121010 (為什麼不給我神奇ID),Re,Fri Nov  8 23:04:40 2019
3,0,3,wjes30325 (台灣的駕駛很棒),Re,Sat Nov  9 05:08:39 2019
4,5,-1,cosmite (Z),[問卦] 搶五樓的人變少了？過氣了嗎？,Sat Nov  9 00:12:29 2019
5,0,5,GODLP (神鳥鳳凰),[問卦] 艾倫準備好了 你們準備好了嗎?,Fri Nov  8 23:39:00 2019
3,1,2,mayingnine (個性決定能否投資賺大錢),[問卦] 有沒有可能一年後 王思聰,Sat Nov  9 10:44:37 2019
0,0,0,eric999 (eric999),Re,Sat Nov  9 10:24:10 2019
8,3,5,deathdecay (AZOTH),[新聞] 宋楚瑜若參選 韓國瑜:他對我的影響比較大,Fri Nov  8 23:06:18 2019
2,12,-10,D600dust (雙標文字獄代PO仔),[問卦] 要離職 要怎麼掰理由,Sat Nov  9 09:59:58 2019
33,3,30,cutiehoneyzu (McHilo),[問卦] 台灣近幾年真的沒有出現知名藝人嗎？,Fri Nov  8 22:57:50 2019
2,0,2,DeltaX (憨9),[問卦] 有沒有最好交情見面初的掛,Fri Nov  8 23:16:17 2019
3,0,3,chekove (tit for tat),[問卦] 請問一下如何判斷打壓或友善啊?,Sat Nov  9 06:16:22 2019
13,21,-8,sevenzgod (7z),[問卦] 為什麼統獨議題都大過民生議題,Sat Nov  9 02:27:59 2019
20,1,19,wwewcwwwf (台灣老闆不要的廢物垃圾),[問卦] 倫敦和附近有啥好玩的?,Sat Nov  9 01:43:51 2019
1,1,0,f17690815 (我恨陣頭),[問卦] 網美知道粉絲都只看圖嗎？,Fri Nov  8 23:51:09 2019
2,0,2,huabandd (我是阿肥巴你頭),Re,Sat Nov  9 11:29:16 2019
9,1,8,a2470abc (D.F.),[問卦] 比較主流的職業中哪個最操？,Sat Nov  9 06:54:00 2019
20,8,12,Abobe (寶嗚),[問卦] 為什麼很多人都喜歡曬小孩,Sat Nov  9 11:05:07 2019
8,1,7,james11song (張嘉航),[問卦] 退後十三步...？,Sat Nov  9 07:59:42 2019
13,3,10,gostjoke (鬼笑話),[問卦] 人被強姦久了是不是就習慣了？,Sat Nov  9 10:39:36 2019
7,1,6,sazabik (SAZABI),Re,Sat Nov  9 06:41:01 2019
8,1,7,CavendishJr (左是炎右是雷),[新聞] 南韓2025年廢除菁英高中 改善社會不平等,Sat Nov  9 08:21:43 2019
5,0,5,aliloveyou (Ali),[問卦] 秒讀秒回是不是很沒禮貌？,Sat Nov  9 04:34:37 2019
223,41,182,excell (Soft On Demand),[新聞] 推薦截止 國民黨不分區決選名單「點將錄,Sat Nov  9 00:26:00 2019
4,0,4,maybetodo (np),[問卦] 專門幫人培養人才的稱為什麼？？,Fri Nov  8 23:13:10 2019
3,1,2,clever0705 (小卒),[問卦] 學公民與道德要幹嘛,Fri Nov  8 23:54:59 2019
6,0,6,ffreakk (),Re,Fri Nov  8 23:51:21 2019
5,0,5,Jyery (文弟),Re,Sat Nov  9 11:44:49 2019
0,0,0,qqmaybenot (qq),Re,Sat Nov  9 10:29:32 2019
3,1,2,AngryYouth (森寶),[問卦] 為什麼我都沒有被水桶,Sat Nov  9 00:25:54 2019
58,5,53,lunqun35 (Sweet Caroline),[問卦] 南拳媽媽當年有多紅？,Sat Nov  9 00:52:45 2019
3,0,3,honkwun (反皮草 拒絕血腥時尚),[新聞] 不忍樹木被塑膠袋環繞 前進設計之都米蘭,Sat Nov  9 10:59:27 2019
152,6,146,RodrigueZ810 (裝小維),Fw,Sat Nov  9 10:40:08 2019
14,10,4,usl2736 (優欸斯诶樓二七三六),[問卦] 小菸來板橋幹嘛？,Sat Nov  9 09:31:50 2019
15,4,11,weeklyquiz (五樓愛露屌),[問卦] 女生小隻叫小隻馬那男生呢,Sat Nov  9 11:53:58 2019
19,1,18,Jacky83502 (qqq99110),[新聞] 新竹市2021台灣燈會設6大燈區 主燈區在新竹公園,Sat Nov  9 00:41:15 2019
2,0,2,maybetodo (np),[問卦] 屁股毛是什麼毛？？,Fri Nov  8 23:28:28 2019
3,4,-1,timetolove (艾爾不怕西諾),[問卦] 欸欸，現在爆雷魔鬼終結者會不會被噓,Sat Nov  9 01:26:17 2019
4,0,4,firsttiti (你在就好了),[問卦] 火車站建築材料的八卦,Sat Nov  9 09:37:14 2019
0,7,-7,fox1234 (狐醜大將軍),[問卦] 饒河夜市是不是種類很少,Sat Nov  9 03:41:42 2019
14,2,12,koheik2 (ko),[問卦] 中山醫大 賺最多 為何排名總是吊車尾?,Sat Nov  9 03:53:46 2019
1,1,0,yuzukineko (閃亮三叔公),[問卦] 提早醒來要怎麼辦？,Sat Nov  9 08:17:29 2019
42,4,38,z5419 (邱哥),[問卦] 最喜歡的AV女優,Sat Nov  9 02:27:11 2019
67,55,12,jay401401 (DDDDD),[爆卦] 無法解釋的靈異現象,Sat Nov  9 00:45:19 2019
4,0,4,viable (隱士灰原I),[問卦] 科學界為什麼不直接改寫相對論?,Sat Nov  9 08:08:50 2019
67,187,-120,zzyyxx77 (討噓大師77),[新聞] 怒批蔡英文執政　韓國瑜：幾流人民選出幾,Sat Nov  9 08:07:44 2019
13,3,10,slb19930308 (斯羅逼),[問卦] 考上高考的女生常批評阿宅怎麼辦？,Sat Nov  9 08:51:21 2019
62,47,15,kades (kades),[新聞] 台中冷血男吃醋殺女友！「孩子沒媽媽太可,Sat Nov  9 09:19:36 2019
18,4,14,wuyiulin (機掰客家人),[問卦] 23歲生日該怎麼慶祝？,Sat Nov  9 06:49:43 2019
5,2,3,wangyc (粒咲杏子的老公),[問卦] 頭皮屑很多的人理光頭,Sat Nov  9 00:35:56 2019
30,8,22,JUNOCARE (陽光！！),[問卦] 鬼滅已經取代海賊 成為最賣座漫畫,Sat Nov  9 01:11:39 2019
4,1,3,gk1329 (),Re,Sat Nov  9 11:01:16 2019
7,0,7,fatotaku (死肥宅),Re,Fri Nov  8 22:54:16 2019
2,0,2,mithralin (工口),[新聞] 臉書張貼淹水照明顯合成 新北檢不起訴,Sat Nov  9 11:55:41 2019
3,1,2,bota (llll),[問卦] 當年英國真的有叫蘇聯鎮壓?,Sat Nov  9 10:11:56 2019
10,1,9,math520 ( ),[問卦] 月薪制比較好還是時薪制的卦,Sat Nov  9 09:39:51 2019
8,3,5,chamge7788 (經濟王7887),[問卦] 拉肚子肛門痛吃正露丸23顆夠嗎,Fri Nov  8 23:00:43 2019
35,1,34,xyz4594 (享受被噓的快感),[問卦] 有吃過養老乃瀧的人現在都幾歲了?,Sat Nov  9 10:37:57 2019
2,1,1,eeth (韓國綜藝社),[新聞] 晒帶龍鳳胎游泳合照 李英愛獲讚母愛爆棚,Sat Nov  9 11:15:55 2019
1,0,1,kiddking (孩子王),[問卦] 為什麼要用地區來分配民代名額？,Fri Nov  8 23:38:14 2019
7,3,4,liang691206 (liang691206),[問卦] 台灣是不是要假清高 裝窮才能成功? ,Sat Nov  9 08:39:45 2019
10,8,2,vi000246 (Vi),[問卦] 明年該回去投票嗎,Sat Nov  9 11:12:03 2019
2,0,2,viable (隱士灰原I),Re,Fri Nov  8 23:42:53 2019
2,0,2,a22298811 (鐵達尼號),[問卦] 誰敢在中韓大戰時狂喊韓國加油呢,Sat Nov  9 02:06:30 2019
20,0,20,wuyiulin (機掰客家人),Re,Sat Nov  9 04:04:03 2019
27,0,27,WeGoYuSheng ( ♂開啟另一道薇閣的門♂),[新聞] 法文化部高官下藥 女性應徵者尿急被迫在他面前尿尿,Sat Nov  9 11:36:29 2019
26,32,-6,Plot3D (3D做圖),[新聞] 蔡壁如邀黃國昌入不分區引發時力群組內訌,Sat Nov  9 09:20:11 2019
1,19,-18,glassspirit (),［問卦］請問這行為是？,Sat Nov  9 10:48:17 2019
2,5,-3,timetolove (艾爾不怕西諾),[問卦] 欸欸，電影售票員好正,Fri Nov  8 23:01:32 2019
8,14,-6,KTR5566 (KTR),[問卦] 150名台勞被中國人強行解雇沒人討論？,Sat Nov  9 11:17:46 2019
10,1,9,ffreakk (),[問卦]炸毛是什麼意思,Fri Nov  8 23:11:13 2019
67,3,64,imericlai (),[問卦] 中共曾經也宣傳要民主嗎？,Sat Nov  9 08:06:41 2019
3,2,1,poeta (鍵盤詩人),[問卦] 哪一家賣的玉湯比較好喝,Sat Nov  9 00:33:31 2019
1,2,-1,sheng612 (無聊的人),Re,Fri Nov  8 22:56:53 2019
4,0,4,viable (隱士灰原I),[問卦] 他人寫的跟我幻聽夢境同步代表?,Fri Nov  8 23:07:50 2019
7,4,3,andonie (台北的天空),[問卦] ASP.net語法與模型 每幾年一變是怎樣,Sat Nov  9 02:09:18 2019
6,4,2,VortexSheet (哦?),[問卦] 有沒有公司監測上網流量的八卦!,Sat Nov  9 08:58:05 2019
3,1,2,DeltaX (憨9),Re,Sat Nov  9 10:48:02 2019
8,4,4,milkBK (blitzkrieg比較低),[問卦] 古人被貶到花蓮會寫文學來抒發嗎？,Sat Nov  9 10:31:47 2019
8,0,8,akway (生活就是要快樂),[新聞] 美中同意取消加徵關稅？ 川普否認,Sat Nov  9 08:03:10 2019
5,2,3,gk1329 (),Re,Sat Nov  9 11:14:42 2019
2,1,1,FastGunMan ( ),[新聞] 轉發「李遠哲爆料蔡英文心中沒有下一代」,Sat Nov  9 11:56:24 2019
2,1,1,Thaichonburi (Hello 你好嗎 衷心感謝),Re,Sat Nov  9 06:23:20 2019
14,3,11,ThisisLongID (長哀滴),Re,Fri Nov  8 23:36:12 2019
8,4,4,fangbr (小肥),[問卦] 驚！Toya Koyo正在和Sai對弈！？,Sat Nov  9 01:02:54 2019
6,3,3,Zeke00 (齊克00),[問卦] 半夜不睡覺容易肚子餓？,Sat Nov  9 02:22:14 2019
9,0,9,ShinozakiAki (要認真˙),Re,Sat Nov  9 08:37:30 2019
1,1,0,UWinKing (尾刀狗本人OuO♥),[問卦] 會把湯匙筷子舔乾淨放回去ㄇ?,Sat Nov  9 02:08:59 2019
2,1,1,slycsboy (帆月),Re,Sat Nov  9 08:16:32 2019
6,1,5,ezJapan (Japan),[問卦] 韓國軍人也卡我們的子瑜,Fri Nov  8 23:51:40 2019
84,3,81,AaronEckhar (Aaron會比緬因州還要熱。),[新聞] 連戰邀談輔選 馬朱韓缺席 吳洪早退,Sat Nov  9 09:12:42 2019
3,2,1,lightwish (穹願),[新聞] 長春長生宣告破產 曾深陷疫苗醜聞,Fri Nov  8 23:43:44 2019
7,3,4,hank49172008 (love yumirin),[問卦] IZONE還有救嗎?,Fri Nov  8 23:50:07 2019
2,2,0,HappyDiD (開心的動一動),[問卦] 喝拿鐵會不會變胖啊？,Sat Nov  9 10:33:09 2019
9,30,-21,hello456 (好無聊......),[新聞] 韓國瑜全國競總設高雄市 歷來總統大選首,Sat Nov  9 10:14:37 2019
2,3,-1,shampoopoo (毛寶洗髮精是了),[問卦] 教授上課耍帥怎麼辦？,Sat Nov  9 05:16:23 2019
9,2,7,jorry111111 (andy),[問卦] 奈良的餓鬼鹿和仙鹿,Sat Nov  9 11:03:04 2019
6,1,5,D600dust (雙標文字獄代PO仔),[問卦] 囚徒困境 怎樣讓其他人最錯愕,Sat Nov  9 10:07:19 2019
9,38,-29,teramars (tomorrow never knows),[新聞] 韓國瑜嘆青年被置入負面元素：亡國感、主,Sat Nov  9 11:46:46 2019
